--------------------------------------------------------------------------------------------------------------------------------------------------------------------------------------------------------
--------------------------------------------------------------------------------------------------------------------------------------------------------------------------------------------------------
--------------------------------------------------------------------------------------------------------------------------------------------------------------------------------------------------------
--------------------------------------------------------------------------------------------------------------------------------------------------------------------------------------------------------
--------------------------------------------------------------------------------------------------------------------------------------------------------------------------------------------------------
--------------------------------------------------------------------------------------------------------------------------------------------------------------------------------------------------------
--------------------------------------------------------------------------------------------------------------------------------------------------------------------------------------------------------
-------------------------------------------------------------------------------------------------------------------------------------------------------------------------------------------------------v
--?---MXM----X---X------XX--X------X----X--X------X-----------X---?----------MB-----------------------------X--------------X--X----X--------X--------X--------M----B-----o---------------o----X-X-----?f
-----M-E-----X---------------------------XB------------?----------------XX-----------X-------X-X--------B-X--B---X-------------X----------------------X--?X-----------------------X--------------------f
-X-----------------EX-------M-------------X--------XXE------------------B--X-----------------X-----M--------X--X----------X---------X--X-B----?--M--------------------------------X-----------oX-----o-f
------X-------------------B----------B----------------E-----X---------X-----------------B------X----X--------X-X-XMM----------B------------M-----B-----o-----------B-X-----------------X-X-X----TX-----f
--------------B-------X-X-------------------X---X------------o---------------X--B---B---X--X------------X-----------X------------B-o-M-X---M----B---------X-----------------XM-------------M----|------f
--------------------XM---------------?---------------X--------------X-----------------E--------------X---M-?---X--X-B----------o----------o-----M---X-----------------X-----X-----------B-X--BX-TX-----f
m---------XXM-----X--X-------X-------X--B------B--X-----------------X-T-T-X-------------------?-----------M---------------------X-X--X---X---------M--X-------T------X----------B---X--E-X------|-----XX
X-XX-XXXXXXX--XXXXXXXXXX-XX-XXXXXXXXXXXXXX-XX-XXXXXXXXX-X-X-X-XXXXXX-X-X-XXXX-X-XXXXXXXXXXX-XXXXXX-XXXXX---XXXXXX--X-XXXXXX-XX--XXX--XXX-X-X-XXXXXXXX-XXXX--XX--XXXXXXXXXXXX-XXXXXXXX-XXXXXXXXXXXXXXXXXX
