XXXXXXXXXXXXXXXXXXXXXXXXXXXXXXXXXXXXXXXXX
Xa23456789123456789123456789123456789123X
X987654321987654321987654321987654321987X
X123456789123456789123456789123456789123X
X987654321987654321987654321987654321987X
X123456789123456789123456789123456789123X
X987654321987654321987654321987654321987X
X123456789123456789123456789123456789123X
X987654321987654321987654321987654321987X
X123456789123456789123456789123456789123X
X987654321987654321987654321987654321987X
X123456789123456789123456789123456789123X
X987654321987654321987654321987654321987X
X123456789123456789123456789123456789123X
X987654321987654321987654321987654321987X
X123456789123456789123456789123456789123X
X987654321987654321987654321987654321987X
X123456789123456789123456789123456789123X
X98765432198b654321987654321987654321987X
X123456789123456789123456789123456789123X
X987654321987654321987654321987654321987X
X123456789123456789123456789123456789123X
X987654321987654321987654321987654321987X
X123456789123456789123456789123456789123X
X987654321987654321987654321987654321987X
X123456789123456789123456789123456789123X
X987654321987654321987654321987654321987X
X123456789123456789123456789123456789123X
X987654321987654321987654321987654321987X
X123456789123456789123456789123456789123X
X987654321987654321987654321987654321987X
X123456789123456789123456789123e56789123X
X987654321987654321987654321987654321987X
X123456789123456789123456789123456789123X
X987654321987654321987654321987654321987X
X123456789123456789123456789123456789123X
X98765432c987654321987654321987654321987X
X123456789123456789123456789123456789123X
X9876543219876543219876543219876d4321987X
X123456789123456789123456789123456789123X
X987654321987654321987654321987654321987X
XXXXXXXXXXXXXXXXXXXXXXXXXXXXXXXXXXXXXXXXX